Функции за работа со текстуални низи од
библиотеката <string.h>

Функции за менување на текстуални низи:
• strcpy() - копирање на една текстуална низа во друга
• strncpy() - копирање на n бајти од една текстуална низа во друга
• strcat() - надоврзува една текстуална низа на крајот на друга
• strncat() - надоврзува n бајти од една текстуална низа на крајот на друга
Функции за менување на меморијата:
• memset() - пополнува низа со одреден бајт
Функции за претворање на текстуални низи во броеви:
• atof() - претвора текстуална низа во децимален број
• atoi() - претвора текстуална низа во цел број
Функции за испитување на текстуални низи:
• strlen() - ја враќа должината на дадена текстуална низа
• strcmp() - споредува две текстуални низи
• strncmp() - споредува n бајти од две текстуални низи
• strchr() - го наоѓа првото појавување на даден знак во текстуална низа
• strrchr() - го наоѓа последното појавување на даден знак во текстуална
низа
• strspn() - во текстуална низа го наоѓа првото појавување на знак кој не
Структурно програмирање
1. Текстуални низи (стрингови) | 1
припаѓа на специфицирано множество од знаци
• strcspn() - во текстуална низа го наоѓа последното појавување на знак кој
не припаѓа на специфицирано множество од знаци
• strpbrk() - во текстуална низа го наоѓа првото појавување на знак кој
припаѓа на специфицирано множество од знаци
• strstr() - во текстуална низа го наоѓа првото појавување на дадена
подниза

Функции за работа со знаци од библиотеката
<ctype.h>
Функции за работа со единечен знак:
• isalnum() - проверува дали даден знак е алфанумерички (буква или цифра)
• isalpha() - проверува дали даден знак е буква
• iscntrl() - проверува дали даден знак е контролен знак
• isdigit() - проверува дали даден знак е декадна цифра
• isxdigit() - проверува дали даден знак е хексадекадна цифра
• isprint() - проверува дали даден знак може да се печати
• ispunct() - проверува дали даден знак е интерпункциски знак
• isspace() - проверува дали даден знак е празно место
• islower() - проверува дали даден знак е мала буква
• isupper() - проверува дали даден знак е голема буква
• tolower() - претвора дадена голема буква во соодветната мала буква
• toupper() - претвора дадена мала буква во соодветната голема буква
• isgraph() - проверува дали даден знак има локална графичка
репрезентација